R 960 640

NO textures/brick_no.xpm
SO textures/brick_so.xpm
WE textures/brick_we.xpm     
EA textures/brick_ea.xpm  

S textures/sprite.xpm      

F 169,169,169
C 105,105,200     

111111111111111111111111111111
100000000000000000000000000021
111111111111111001111111111111
100100000000100001010000000001
100100111110000001011111111001
100100111110000000000000001001
100100100011111111111111101001
100100000010000000022200101001
100111100010000000000000101001
100000100010000000000000101001
110111100111111111110111101111
100000000000000000000000000001
100000002222200000000000000001
100000000000000000000100000001
100000002222200000000100000001
100000000000000000000100020001
100000002222200000000100000001
100000000000000000000100000001
1000000000N0000000000100000001
111111111111111111111111111111