R 960  640

    NO    Textures/brick_no.xpm
 SO Textures/brick_so.xpm
WE Textures/brick_we.xpm          
EA Textures/brick_ea.xpm

S Textures/sprite.xpm

F 169, 169, 169   
C 5, 105, 200      


111111111111111111111111111111
100000000000001210000000000021
100111111111111000222222222001
100100000000100001010000000001
100100111110000001011111111001
100100111110000000000000000001
100100100011111111111111100001
100110000000000222220000100001
100110000000000000000000000001
100000000000000222220000100001
100111100111111111111111100111
100000000000000000000000000001
10000000222220000N000000000001
100000000000000000000100000001
100000002222200000000100000001
100000000000000000000100020001
100000000000000000000100000001
100000000000000000000100000001
100000000000000000000100000001
111111111111111111111111111111